type octile
height 11
width 10
map
..........
..........
..........
....T.....
...TTT....
...T.T....
...TTT....
....T.....
....T.....
....T.....
..........