type octile
height 20
width 20
map
....................
....................
....................
....................
....................
....TTTTTTTTTTT.....
....TTTTTTTTTTT.....
....TTTTTTTTTTT.....
............TTT.....
............TTT.....
............TTT.....
............TTT.....
............TTT.....
....................
....................
....................
....................
....................
....................
....................